Date,Payee,Debits,Credits,Balance,Memo,OrigPayee,Expense Type
12/30/2019,atm deposit - ed214139,,-2373,-4416.96,,ATM deposit - ED214139,Undefined
12/30/2019,interac purchase - 7577 save meat an,-292,,,,Interac purchase - 7577 SAVE ON MEAT AN,Undefined
12/30/2019,contactless interac purchase - 8910,-20.47,,,MO'S PIZZA AND,Contactless Interac purchase - 8910,Undefined
12/30/2019,contactless interac purchase - 6473,-24,,,PARADISO PASTRI,Contactless Interac purchase - 6473,Undefined
12/30/2019,contactless interac purchase - 5214,-71.27,,,MEDICINE PLACE,Contactless Interac purchase - 5214,Undefined
12/30/2019,online transfer sent - 6841 khaled alardud,-200,,-3809.22,,Online transfer sent - 6841 KHALED ALARDUD,Undefined
1/2/2020,interac purchase - 5900 mobil@ - 1772,-57.6,,,,Interac purchase - 5900 MOBIL@ - 1772,Fuel costs
1/2/2020,contactless interac purchase - 4762,-72.54,,,REAL CDN SUPERS,Contactless Interac purchase - 4762,Undefined
1/2/2020,safe deposit box fee incl gst: $4.50,-94.5,,,,Safe deposit box fee Incl GST: $4.50,Undefined
1/2/2020,misc payment pay-file fees,-2,,,,Misc Payment PAY-FILE FEES,Undefined
1/2/2020,auto insurance millennium ins,-197.33,,,,Auto Insurance MILLENNIUM INS,Undefined
1/2/2020,insurance cooperators csi,-417.92,,-2967.33,,Insurance Cooperators CSI,Undefined
1/2/2020,monthly fee,-5,,,,Monthly fee,Undefined
1/2/2020,regular transaction fee 1 dr 2.50,-2.5,,-2959.83,,Regular transaction fee 1 Dr  2.50,Undefined
1/3/2020,interac purchase - 0389 shell flying J,-300,,-2659.83,,Interac purchase - 0389 SHELL FLYING J,Fuel costs
1/6/2020,e-transfer received g.s.b. trucking inc.,,-4204.71,-6864.54,,e-Transfer received G.S.B. TRUCKING INC.,Undefined
1/6/2020,interac purchase - 8280 northtown regis,-75,,,,Interac purchase - 8280 NORTHTOWN REGIS,Undefined
1/6/2020,interac purchase - 8114 petro-canada,-80,,,,Interac purchase - 8114 PETRO-CANADA,Fuel costs
1/6/2020,interac purchase - 7944 northtown regis,-229,,,,Interac purchase - 7944 NORTHTOWN REGIS,Undefined
1/6/2020,contactless interac purchase - 5030,-47.86,,,ELSAFADI FOOD M,Contactless Interac purchase - 5030,Undefined
1/6/2020,online transfer sent - 5883 khaled alardud,-200,,-6232.68,,Online transfer sent - 5883 KHALED ALARDUD,Undefined
1/7/2020,contactless interac purchase - 3419,-4.49,,-6228.19,TIM HORTONS #83,Contactless Interac purchase - 3419,Undefined
1/8/2020,contactless interac purchase - 4904,-10.5,,,SPECTRUM TEL,Contactless Interac purchase - 4904,Undefined
1/8/2020,contactless interac purchase - 4440,-36,,-6181.69,REAL CDN SUPERS,Contactless Interac purchase - 4440,Undefined
1/9/2020,contactless interac purchase - 5173,-6.15,,-6175.54,TIM HORTONS #34,Contactless Interac purchase - 5173,Undefined
1/10/2020,atm deposit - ei311662,,-1328,,,ATM deposit - EI311662,Undefined
1/10/2020,e-transfer sent bashir,-2000,,-5503.54,,e-Transfer sent Bashir,Undefined
1/10/2020,contactless interac purchase - 2311,-7.25,,,SUNBAKE PITA BA,Contactless Interac purchase - 2311,Undefined
1/10/2020,contactless interac purchase - 9423,-7.25,,,SUNBAKE PITA BA,Contactless Interac purchase - 9423,Undefined
1/10/2020,contactless interac purchase - 5781,-40.95,,-5448.09,THE BEDOUINS RE,Contactless Interac purchase - 5781,Undefined
1/13/2020,e-transfer sent bashir,-2000,,-3448.09,,e-Transfer sent Bashir,Undefined
1/13/2020,interac purchase - 6190 creit esso,-60,,,,Interac purchase - 6190 CREIT ESSO,Fuel costs
1/13/2020,contactless interac purchase - 6272,-52.5,,,TOP 1 MASSAGE &,Contactless Interac purchase - 6272,Undefined
1/13/2020,online banking transfer - 9243,-62.74,,-3272.85,,Online Banking transfer - 9243,Undefined
1/14/2020,e-transfer sent bashir,-1800,,-1472.85,,e-Transfer sent Bashir,Undefined
1/15/2020,interac purchase - 2798 c01 dit170st-o,-50.99,,,,Interac purchase - 2798 C01 DIT(170ST-O,Undefined
1/15/2020,contactless interac purchase - 5990,-44.78,,-1377.08,REAL CDN SUPERS,Contactless Interac purchase - 5990,Undefined
1/16/2020,interac purchase - 2146 shell flying J,-200,,-1177.08,,Interac purchase - 2146 SHELL FLYING J,Fuel costs
1/17/2020,payroll deposit g.s.b. trucking,,-2141.94,,,Payroll Deposit G.S.B. TRUCKING,Undefined
1/17/2020,interac purchase - 7327 lucky supermark,-14.55,,,,Interac purchase - 7327 LUCKY SUPERMARK,Undefined
1/17/2020,contactless interac purchase - 2500,-34.46,,,REAL CDN SUPERS,Contactless Interac purchase - 2500,Undefined
1/17/2020,contactless interac purchase - 1589,-36.74,,-3233.27,SHOPPERS DRUG M,Contactless Interac purchase - 1589,Undefined
1/20/2020,interac purchase - 2645 shell flying J,-300,,,,Interac purchase - 2645 SHELL FLYING J,Fuel costs
1/20/2020,insurance cooperators csi,-279.84,,-2653.43,,Insurance Cooperators CSI,Undefined
1/21/2020,interac purchase - 2830 shell flying J,-300,,,,Interac purchase - 2830 SHELL FLYING J,Fuel costs
1/21/2020,contactless interac purchase - 0977,-2.09,,-2351.34,TIM HORTONS #74,Contactless Interac purchase - 0977,Undefined
1/23/2020,interac purchase - 8967 c01 dit170st-o,-56.39,,,,Interac purchase - 8967 C01 DIT(170ST-O,Undefined
1/23/2020,interac purchase - 5683 petro-canada,-57.39,,-2237.56,,Interac purchase - 5683 PETRO-CANADA,Fuel costs
1/24/2020,contactless interac purchase - 2501,-8.84,,-2228.72,TIM HORTONS #83,Contactless Interac purchase - 2501,Undefined
1/27/2020,contactless interac purchase - 0946,-2.09,,,TIM HORTONS #11,Contactless Interac purchase - 0946,Undefined
1/27/2020,contactless interac purchase - 5091,-2.09,,,TIM HORTONS #11,Contactless Interac purchase - 5091,Undefined
1/27/2020,contactless interac purchase - 7842,-2.63,,,KABSA THE ULTIM,Contactless Interac purchase - 7842,Undefined
1/27/2020,contactless interac purchase - 0939,-46.69,,-2175.22,KABSA THE ULTIM,Contactless Interac purchase - 0939,Undefined
4/30/2020,e-transfer sent fwaziy,-2000,,-748.81,,e-Transfer sent fwaziy,Undefined
4/30/2020,online banking transfer - 5233,,-40000,,,Online Banking transfer - 5233,Undefined
4/30/2020,misc payment clarke transpor,,-2341.05,-43089.86,,Misc Payment CLARKE TRANSPOR,Undefined
5/1/2020,atm deposit - ei313830,,-682.35,-43772.21,,ATM deposit - EI313830,Undefined
5/1/2020,br to br - 1599,-4323,,,,BR TO BR - 1599,Undefined
5/1/2020,online banking transfer - 5664,-95.55,,,,Online Banking transfer - 5664,Undefined
5/1/2020,misc payment pay-file fees,-2,,,,Misc Payment PAY-FILE FEES,Undefined
5/1/2020,auto insurance millennium ins,-197.33,,,,Auto Insurance MILLENNIUM INS,Undefined
5/1/2020,insurance cooperators csi,-451.84,,-38702.49,,Insurance Cooperators CSI,Undefined
5/1/2020,monthly fee,-5,,,,Monthly fee,Undefined
5/1/2020,regular transaction fee 1 dr 2.50,-2.5,,-38694.99,,Regular transaction fee 1 Dr  2.50,Undefined
5/4/2020,e-transfer sent fwaziy,-200,,-38494.99,,e-Transfer sent fwaziy,Undefined
5/4/2020,interac purchase - 3421 shell flying J,-400,,,,Interac purchase - 3421 SHELL FLYING J,Fuel costs
5/4/2020,contactless interac purchase - 3351,-7.73,,-38087.26,TIM HORTONS #16,Contactless Interac purchase - 3351,Undefined
5/6/2020,contactless interac purchase - 5070,-9.83,,,MCDONALD'S #400,Contactless Interac purchase - 5070,Undefined
5/6/2020,br to br - 5429,-3000,,,,BR TO BR - 5429,Undefined
5/6/2020,br to br - 1599,-5721.2,,-29356.23,,BR TO BR - 1599,Undefined
5/7/2020,misc payment clarke transpor,,-1310.69,,,Misc Payment CLARKE TRANSPOR,Undefined
5/7/2020,interac purchase - 0394 shell flying J,-47.64,,,,Interac purchase - 0394 SHELL FLYING J,Fuel costs
5/7/2020,contactless interac purchase - 2471,-14.23,,-30605.05,FORT GARRY INDU,Contactless Interac purchase - 2471,Undefined
5/11/2020,atm deposit - ei315544,,-1302.25,,,ATM deposit - EI315544,Undefined
5/11/2020,e-transfer sent abulhafat,-1500,,-30407.3,,e-Transfer sent abulhafat,Undefined
5/11/2020,contactless interac purchase - 7495,-2.5,,,TIM HORTONS #29,Contactless Interac purchase - 7495,Undefined
5/11/2020,br to br - 1599,-4276.8,,-26128,,BR TO BR - 1599,Undefined
5/12/2020,interac purchase - 0441 shell flying J,-400,,-25728,,Interac purchase - 0441 SHELL FLYING J,Fuel costs
5/13/2020,interac purchase - 7582 shell c11994,-19.94,,,,Interac purchase - 7582 SHELL C11994,Fuel costs
5/13/2020,interac purchase - 4351 calg co-op gas,-47.34,,,,Interac purchase - 4351 CALG CO-OP GAS,Fuel costs
5/13/2020,contactless interac purchase - 0703,-10.38,,-25650.34,MCDONALD'S #290,Contactless Interac purchase - 0703,Undefined
5/14/2020,misc payment clarke transpor,,-4133.6,,,Misc Payment CLARKE TRANSPOR,Undefined
5/14/2020,contactless interac purchase - 7238,-9.4,,-29774.54,TIM HORTONS #21,Contactless Interac purchase - 7238,Undefined
5/19/2020,interac purchase - 9324 city truck stop,-362.84,,,,Interac purchase - 9324 CITY TRUCK STOP,Undefined
5/19/2020,contactless interac purchase - 0235,-2.5,,,TIM HORTONS #16,Contactless Interac purchase - 0235,Undefined
5/19/2020,contactless interac purchase - 0468,-13.4,,,C01 DIT(170ST-O,Contactless Interac purchase - 0468,Undefined
5/19/2020,contactless interac purchase - 3014,-36.86,,,CITY TRUCK STOP,Contactless Interac purchase - 3014,Undefined
5/19/2020,contactless interac purchase - 2261,-69.6,,,FIRST TRUCK CEN,Contactless Interac purchase - 2261,Undefined
5/19/2020,insurance cooperators csi,-290.5,,-28998.84,,Insurance Cooperators CSI,Undefined
5/20/2020,interac purchase - 4142 ritchie bros.au,-1848,,,,Interac purchase - 4142 RITCHIE BROS.AU,Undefined
5/20/2020,online banking interac purchase - 6079,-885,,-26265.84,Canada Revenue,Online Banking Interac purchase - 6079,Undefined
5/22/2020,interac purchase - 1644 mobil@ - 1772,-54.16,,,,Interac purchase - 1644 MOBIL@ - 1772,Fuel costs
5/22/2020,interac purchase - 3000 princess auto 0,-157.48,,,,Interac purchase - 3000 PRINCESS AUTO 0,Undefined
5/22/2020,contactless interac purchase - 2291,-2.29,,-26051.91,TIM HORTONS #11,Contactless Interac purchase - 2291,Undefined
5/25/2020,interac purchase - 4585 shell flying J,-400,,,,Interac purchase - 4585 SHELL FLYING J,Fuel costs
5/25/2020,contactless interac purchase - 0620,-10.46,,,TIM HORTONS #11,Contactless Interac purchase - 0620,Undefined
5/25/2020,cash withdrawal,-196,,-25445.45,,Cash withdrawal,Undefined
8/28/2020,interac purchase - 1300 city truck stop,-25.99,,,,Interac purchase - 1300 CITY TRUCK STOP,Undefined
8/28/2020,interac purchase - 6305 a. alberta regi,-140,,-2900.97,,Interac purchase - 6305 A. ALBERTA REGI,Undefined
8/31/2020,interac purchase - 3770 allspec diesel,-221.25,,-2679.72,,Interac purchase - 3770 ALLSPEC DIESEL,Undefined
9/1/2020,interac purchase - 2287 shell flying J,-200,,,,Interac purchase - 2287 SHELL FLYING J,Fuel costs
9/1/2020,misc payment pay-file fees,-2,,,,Misc Payment PAY-FILE FEES,Undefined
9/1/2020,auto insurance millennium ins,-194.25,,,,Auto Insurance MILLENNIUM INS,Undefined
9/1/2020,insurance cooperators csi,-420.64,,-1862.83,,Insurance Cooperators CSI,Undefined
9/1/2020,monthly fee,-5,,,,Monthly fee,Undefined
9/1/2020,regular transaction fee 3 drs 2.50,-7.5,,-1850.33,,Regular transaction fee 3 Drs  2.50,Undefined
9/2/2020,interac purchase - 1842 hot plates inc,-47.25,,,,Interac purchase - 1842 HOT PLATES INC,Undefined
9/2/2020,interac purchase - 4664 esso 7-eleven 3,-60,,,,Interac purchase - 4664 ESSO 7-ELEVEN 3,Fuel costs
9/2/2020,interac purchase - 9025 turquaz kebab H,-67.94,,-1675.14,,Interac purchase - 9025 TURQUAZ KEBAB H,Undefined
9/3/2020,misc payment clarke transpor,,-2328.24,-4003.38,,Misc Payment CLARKE TRANSPOR,Undefined
9/4/2020,interac purchase - 2075 shell flying J,-0.66,,,,Interac purchase - 2075 SHELL FLYING J,Fuel costs
9/4/2020,interac purchase - 1277 shell flying J,-100,,,,Interac purchase - 1277 SHELL FLYING J,Fuel costs
9/4/2020,interac purchase - 6897 shell flying J,-150,,,,Interac purchase - 6897 SHELL FLYING J,Fuel costs
9/4/2020,online banking transfer - 6182,-859.29,,-2893.43,,Online Banking transfer - 6182,Undefined
9/8/2020,e-transfer sent abdo,-250,,-2643.43,,e-Transfer sent abdo,Undefined
9/8/2020,interac purchase - 7684 wal-mart,-3.87,,,,Interac purchase - 7684 WAL-MART #1028,Supplies
9/8/2020,interac purchase - 0442 esso 7-eleven 3,-3.89,,,,Interac purchase - 0442 ESSO 7-ELEVEN 3,Fuel costs
9/8/2020,interac purchase - 6652 esso 7-eleven 3,-3.99,,,,Interac purchase - 6652 ESSO 7-ELEVEN 3,Fuel costs
9/8/2020,interac purchase - 7015 shell flying J,-7.33,,,,Interac purchase - 7015 SHELL FLYING J,Fuel costs
9/8/2020,interac purchase - 5691 shell flying J,-7.49,,,,Interac purchase - 5691 SHELL FLYING J,Fuel costs
9/8/2020,interac purchase - 9986 sunbake pita ba,-10,,,,Interac purchase - 9986 SUNBAKE PITA BA,Undefined
9/8/2020,interac purchase - 2107 fossil world ju,-23.63,,,,Interac purchase - 2107 FOSSIL WORLD JU,Undefined
9/8/2020,interac purchase - 8146 kabsa the ultim,-48.27,,,,Interac purchase - 8146 KABSA THE ULTIM,Undefined
9/8/2020,interac purchase - 8903 petro-canada,-60,,,,Interac purchase - 8903 PETRO-CANADA,Fuel costs
9/8/2020,interac purchase - 3284 real cdn supers,-74.94,,,,Interac purchase - 3284 REAL CDN SUPERS,Undefined
9/8/2020,interac purchase - 6877 esso 7-eleven 3,-91.87,,,,Interac purchase - 6877 ESSO 7-ELEVEN 3,Fuel costs
9/8/2020,interac purchase - 1099 elsafadi medite,-92.67,,-2215.48,,Interac purchase - 1099 ELSAFADI MEDITE,Supplies
9/9/2020,interac purchase - 4709 shell flying J,-7.33,,,,Interac purchase - 4709 SHELL FLYING J,Fuel costs
9/9/2020,interac purchase - 8179 c01 dit170st-o,-21.27,,-2186.88,,Interac purchase - 8179 C01 DIT(170ST-O,Undefined
9/10/2020,misc payment clarke transpor,,-1955.45,,,Misc Payment CLARKE TRANSPOR,Undefined
9/10/2020,interac purchase - 1377 shell flying J,-3.34,,,,Interac purchase - 1377 SHELL FLYING J,Fuel costs
9/10/2020,interac purchase - 6755 real cdn supers,-9.71,,-4129.28,,Interac purchase - 6755 REAL CDN SUPERS,Undefined
9/11/2020,interac purchase - 5802 real cdn supers,-15,,,,Interac purchase - 5802 REAL CDN SUPERS,Undefined
9/11/2020,interac purchase - 0997 kabsa the ultim,-48.27,,,,Interac purchase - 0997 KABSA THE ULTIM,Undefined
9/11/2020,interac purchase - 3914 shell flying J,-100,,,,Interac purchase - 3914 SHELL FLYING J,Fuel costs
9/11/2020,interac purchase - 0167 fort garry indu,-126.93,,-3839.08,,Interac purchase - 0167 FORT GARRY INDU,Undefined
9/14/2020,interac purchase - 7995 tim hortons,-3.14,,,,Interac purchase - 7995 TIM HORTONS #83,Meals and entertainment
9/14/2020,interac purchase - 0976 princess auto 0,-22,,,,Interac purchase - 0976 PRINCESS AUTO 0,Undefined
9/14/2020,interac purchase - 6373 wholesale liqui,-42.29,,,,Interac purchase - 6373 WHOLESALE LIQUI,Undefined
9/14/2020,interac purchase - 4526 shell flying J,-100,,,,Interac purchase - 4526 SHELL FLYING J,Fuel costs
9/14/2020,online transfer sent - 0356 khaled alardud,-300,,,,Online transfer sent - 0356 KHALED ALARDUD,Undefined
9/14/2020,online transfer sent - 9023 khaled alardud,-300,,-3071.65,,Online transfer sent - 9023 KHALED ALARDUD,Undefined
9/15/2020,interac purchase - 6284 petro-canada,-80,,-2991.65,,Interac purchase - 6284 PETRO-CANADA,Fuel costs
9/16/2020,e-transfer sent nezar,-2000,,-991.65,,e-Transfer sent Nezar,Undefined
9/16/2020,interac purchase - 3278 tim hortons,-8.57,,,,Interac purchase - 3278 TIM HORTONS #75,Meals and entertainment
9/16/2020,interac purchase - 1669 mobil@ - 1772,-40,,,,Interac purchase - 1669 MOBIL@ - 1772,Fuel costs
9/16/2020,interac purchase - 9011 costco wholesal,-79.56,,-863.52,,Interac purchase - 9011 COSTCO WHOLESAL,Supplies
9/17/2020,e-transfer sent nezar,-2000,,1136.48,,e-Transfer sent Nezar,Undefined
9/17/2020,misc payment clarke transpor,,-4356.31,-3219.83,,Misc Payment CLARKE TRANSPOR,Undefined
9/18/2020,atm deposit - ei318135,,-1180,,,ATM deposit - EI318135,Undefined
9/18/2020,e-transfer sent nezar,-2000,,-2399.83,,e-Transfer sent Nezar,Undefined
9/18/2020,interac purchase - 9892 tim hortons,-4.49,,,,Interac purchase - 9892 TIM HORTONS #83,Meals and entertainment
9/18/2020,atm cash-back withdrawal - ei318136,-100,,-2295.34,,ATM Cash-back withdrawal - EI318136,Undefined
9/21/2020,e-transfer sent nezar,-600,,,,e-Transfer sent Nezar,Undefined
9/21/2020,e-transfer sent sarder,-1000,,-695.34,,e-Transfer sent sarder,Undefined
9/21/2020,atm withdrawal - ed751161,-60,,,,ATM withdrawal - ED751161,Undefined
9/21/2020,interac purchase - 7537 tim hortons,-5.81,,,,Interac purchase - 7537 TIM HORTONS #28,Meals and entertainment
9/21/2020,interac purchase - 7968 shell flying J,-8.27,,,,Interac purchase - 7968 SHELL FLYING J,Fuel costs
9/21/2020,insurance cooperators csi,-342.5,,-278.76,,Insurance Cooperators CSI,Undefined
9/22/2020,interac purchase - 6599 mediterranean P,-13,,-265.76,,Interac purchase - 6599 MEDITERRANEAN P,Undefined
9/24/2020,misc payment clarke transpor,,-3841.27,,,Misc Payment CLARKE TRANSPOR,Undefined
9/24/2020,interac purchase - 1527 first truck cen,-8.12,,-4098.91,,Interac purchase - 1527 FIRST TRUCK CEN,Undefined
9/25/2020,interac purchase - 9900 tim hortons,-3.13,,,,Interac purchase - 9900 TIM HORTONS #22,Meals and entertainment
9/25/2020,interac purchase - 3610 general food,-8.43,,,,Interac purchase - 3610 OK GENERAL FOOD,Undefined
9/25/2020,interac purchase - 0561 petro-canada,-79.07,,-4008.28,,Interac purchase - 0561 PETRO-CANADA,Fuel costs
2/28/2020,interac purchase - 1497 turquaz kebab H,-12.5,,,,Interac purchase - 1497 TURQUAZ KEBAB H,Undefined
2/28/2020,contactless interac purchase - 0197,-10.45,,,BINGO PIZZA DON,Contactless Interac purchase - 0197,Undefined
2/28/2020,contactless interac purchase - 6184,-19.95,,,THE BEDOUINS RE,Contactless Interac purchase - 6184,Undefined
2/28/2020,contactless interac purchase - 0102,-23.32,,,BINGO PIZZA DON,Contactless Interac purchase - 0102,Undefined
2/28/2020,online transfer sent - 3383 khaled alardud,-1300,,-4736.88,,Online transfer sent - 3383 KHALED ALARDUD,Undefined
3/2/2020,interac purchase - 6975 kabsa the ultim,-48.27,,,,Interac purchase - 6975 KABSA THE ULTIM,Undefined
3/2/2020,contactless interac purchase - 3836,-3.86,,,TIM HORTONS #74,Contactless Interac purchase - 3836,Undefined
3/2/2020,contactless interac purchase - 6976,-4.59,,,TIM HORTONS #11,Contactless Interac purchase - 6976,Undefined
3/2/2020,contactless interac purchase - 1881,-21.76,,,SUNBAKE PITA BA,Contactless Interac purchase - 1881,Undefined
3/2/2020,contactless interac purchase - 6302,-40.95,,,THE BEDOUINS RE,Contactless Interac purchase - 6302,Undefined
3/2/2020,misc payment pay-file fees,-2,,,,Misc Payment PAY-FILE FEES,Undefined
3/2/2020,auto insurance millennium ins,-197.33,,,,Auto Insurance MILLENNIUM INS,Undefined
3/2/2020,insurance cooperators csi,-417.92,,-4000.2,,Insurance Cooperators CSI,Undefined
3/2/2020,monthly fee,-5,,-3995.2,,Monthly fee,Undefined
3/3/2020,interac purchase - 0672 mobile klinik,-135.95,,,,Interac purchase - 0672 MOBILE KLINIK #,Fuel costs
3/3/2020,interac purchase - 9327 shell flying J,-300,,,,Interac purchase - 9327 SHELL FLYING J,Fuel costs
3/3/2020,online banking transfer - 1060,-939.25,,-2620,,Online Banking transfer - 1060,Undefined
3/5/2020,misc payment clarke transpor,,-3456.51,,,Misc Payment CLARKE TRANSPOR,Undefined
3/5/2020,contactless interac purchase - 0974,-4.8,,-6071.71,TIM HORTONS #75,Contactless Interac purchase - 0974,Undefined
3/6/2020,interac purchase - 5739 shell flying J,-300,,,,Interac purchase - 5739 SHELL FLYING J,Fuel costs
3/6/2020,contactless interac purchase - 3796 lazio 97,-3.05,,,,Contactless Interac purchase - 3796 LAZIO 97,Undefined
3/6/2020,contactless interac purchase - 5668 lazio 97,-3.68,,,,Contactless Interac purchase - 5668 LAZIO 97,Undefined
3/6/2020,online transfer sent - 2677 khaled alardud,-300,,-5464.98,,Online transfer sent - 2677 KHALED ALARDUD,Undefined
3/9/2020,atm withdrawal - ee673530,-280,,,,ATM withdrawal - EE673530,Undefined
3/9/2020,contactless interac purchase - 5151 lazio 97,-9.14,,,,Contactless Interac purchase - 5151 LAZIO 97,Undefined
3/9/2020,contactless interac purchase - 5612,-9.45,,,ITALIAN CENTRE,Contactless Interac purchase - 5612,Undefined
3/9/2020,contactless interac purchase - 6872,-35.69,,,BINGO PIZZA DON,Contactless Interac purchase - 6872,Undefined
3/9/2020,contactless interac purchase - 8196,-52.5,,-5078.2,TOP 1 MASSAGE &,Contactless Interac purchase - 8196,Undefined
3/10/2020,interac purchase - 2162 shell flying J,-4.63,,,,Interac purchase - 2162 SHELL FLYING J,Fuel costs
3/10/2020,interac purchase - 5685 shell flying J,-5.37,,-5068.2,,Interac purchase - 5685 SHELL FLYING J,Fuel costs
3/11/2020,interac purchase - 0894 turquaz kebab H,-12.5,,,,Interac purchase - 0894 TURQUAZ KEBAB H,Undefined
3/11/2020,interac purchase - 6967 shell c03403,-48.32,,,,Interac purchase - 6967 SHELL C03403,Fuel costs
3/11/2020,contactless interac purchase - 7490,-5.53,,,TIM HORTONS #27,Contactless Interac purchase - 7490,Undefined
3/11/2020,contactless interac purchase - 9466 lazio 97,-8.09,,-4993.76,,Contactless Interac purchase - 9466 LAZIO 97,Undefined
3/12/2020,misc payment clarke transpor,,-2431.46,,,Misc Payment CLARKE TRANSPOR,Undefined
3/12/2020,contactless interac purchase - 3113,-2.09,,,TIM HORTONS #83,Contactless Interac purchase - 3113,Undefined
3/12/2020,contactless interac purchase - 0827,-5.42,,-7417.71,TIM HORTONS #27,Contactless Interac purchase - 0827,Undefined
3/13/2020,interac purchase - 9888 save meat an,-309.97,,,,Interac purchase - 9888 SAVE ON MEAT AN,Undefined
3/13/2020,contactless interac purchase - 4060 karim meats,-65,,,,Contactless Interac purchase - 4060 KARIM MEATS,Undefined
3/13/2020,online transfer sent - 1080 khaled alardud,-2000,,-5042.74,,Online transfer sent - 1080 KHALED ALARDUD,Undefined
3/16/2020,interac purchase - 3113 shell flying J,-300,,,,Interac purchase - 3113 SHELL FLYING J,Fuel costs
3/16/2020,online transfer sent - 8086 khaled alardud,-2000,,-2742.74,,Online transfer sent - 8086 KHALED ALARDUD,Undefined
3/17/2020,interac purchase - 3280 city truck stop,-35.65,,,,Interac purchase - 3280 CITY TRUCK STOP,Undefined
3/17/2020,contactless interac purchase - 1466,-31.5,,,CITY TRUCK STOP,Contactless Interac purchase - 1466,Undefined
3/17/2020,online transfer sent - 9626 khaled alardud,-2000,,-675.59,,Online transfer sent - 9626 KHALED ALARDUD,Undefined
3/18/2020,interac purchase - 6042 shell flying J,-3.66,,-671.93,,Interac purchase - 6042 SHELL FLYING J,Fuel costs
3/19/2020,misc payment clarke transpor,,-3388.86,,,Misc Payment CLARKE TRANSPOR,Undefined
3/19/2020,interac purchase - 4882 shell flying J,-6.03,,,,Interac purchase - 4882 SHELL FLYING J,Fuel costs
3/19/2020,interac purchase - 5909 shell flying J,-200,,,,Interac purchase - 5909 SHELL FLYING J,Fuel costs
3/19/2020,insurance cooperators csi,-279.84,,-3574.92,,Insurance Cooperators CSI,Undefined
3/20/2020,atm withdrawal - ei317389,-370,,,,ATM withdrawal - EI317389,Undefined
3/20/2020,online transfer sent - 5054 khaled alardud,-2000,,-1204.92,,Online transfer sent - 5054 KHALED ALARDUD,Undefined
3/23/2020,e-transfer received borama trucking ltd.,,-776.25,-1981.17,,e-Transfer received BORAMA TRUCKING LTD.,Undefined
3/23/2020,interac purchase - 6327 canadian tire,-167.97,,-1813.2,,Interac purchase - 6327 CANADIAN TIRE #,Undefined
3/24/2020,e-transfer sent libya,-200,,-1613.2,,e-Transfer sent libya,Undefined
3/24/2020,interac purchase - 1962 shell flying J,-300,,-1313.2,,Interac purchase - 1962 SHELL FLYING J,Fuel costs
3/26/2020,misc payment clarke transpor,,-2037.36,,,Misc Payment CLARKE TRANSPOR,Undefined
3/26/2020,interac purchase - 3172 shell flying J,-7.85,,-3342.71,,Interac purchase - 3172 SHELL FLYING J,Fuel costs
3/27/2020,e-transfer sent fwaziy,-1278,,-2064.71,,e-Transfer sent fwaziy,Undefined
1/28/2020,interac purchase - 9549 princess auto 0,-262.87,,,,Interac purchase - 9549 PRINCESS AUTO 0,Undefined
1/28/2020,contactless interac purchase - 1881,-4.48,,,TIM HORTONS #24,Contactless Interac purchase - 1881,Undefined
1/28/2020,contactless interac purchase - 0296,-7.12,,-1900.75,MCDONALD'S #626,Contactless Interac purchase - 0296,Undefined
1/29/2020,interac purchase - 1066 shell flying J,-9.57,,,,Interac purchase - 1066 SHELL FLYING J,Fuel costs
1/29/2020,interac purchase - 2019 shell flying J,-400,,-1491.18,,Interac purchase - 2019 SHELL FLYING J,Fuel costs
1/30/2020,online transfer sent - 0426 khaled alardud,-300,,,,Online transfer sent - 0426 KHALED ALARDUD,Undefined
1/30/2020,online banking transfer - 8130,-267.74,,-923.44,,Online Banking transfer - 8130,Undefined
2/3/2020,payroll deposit g.s.b. trucking,,-1238.91,,,Payroll Deposit G.S.B. TRUCKING,Undefined
2/3/2020,interac purchase - 5388 shell flying J,-400,,,,Interac purchase - 5388 SHELL FLYING J,Fuel costs
2/3/2020,contactless interac purchase - 8145,-2.09,,,TIM HORTONS #16,Contactless Interac purchase - 8145,Undefined
2/3/2020,contactless interac purchase - 4116,-8.84,,,WHOLESALE LIQUI,Contactless Interac purchase - 4116,Undefined
2/3/2020,contactless interac purchase - 3183,-11.42,,,STAPLES #244,Contactless Interac purchase - 3183,Undefined
2/3/2020,contactless interac purchase - 9963,-55.54,,,SAVE ON MEAT AN,Contactless Interac purchase - 9963,Undefined
2/3/2020,misc payment pay-file fees,-2,,,,Misc Payment PAY-FILE FEES,Undefined
2/3/2020,auto insurance millennium ins,-197.33,,,,Auto Insurance MILLENNIUM INS,Undefined
2/3/2020,insurance cooperators csi,-417.92,,-1067.21,,Insurance Cooperators CSI,Undefined
2/3/2020,monthly fee,-5,,,,Monthly fee,Undefined
2/3/2020,regular transaction fee 1 dr 2.50,-2.5,,-1059.71,,Regular transaction fee 1 Dr  2.50,Undefined
2/4/2020,interac purchase - 3073 fleet brake br9,-33.6,,-1026.11,,Interac purchase - 3073 FLEET BRAKE BR9,Undefined
2/5/2020,interac purchase - 2157 petro-canada,-50,,-976.11,,Interac purchase - 2157 PETRO-CANADA,Fuel costs
2/7/2020,interac purchase - 7323 shell flying J,-200,,,,Interac purchase - 7323 SHELL FLYING J,Fuel costs
2/7/2020,contactless interac purchase - 3703,-11.13,,,FORT GARRY INDU,Contactless Interac purchase - 3703,Undefined
2/7/2020,online transfer sent - 2386 khaled alardud,-300,,-464.98,,Online transfer sent - 2386 KHALED ALARDUD,Undefined
2/10/2020,interac purchase - 3398 c01 dit170st-o,-41.35,,,,Interac purchase - 3398 C01 DIT(170ST-O,Undefined
2/10/2020,interac purchase - 9242 shell flying J,-300,,,,Interac purchase - 9242 SHELL FLYING J,Fuel costs
2/10/2020,contactless interac purchase - 7043,-8.89,,,ELSAFADI FOOD M,Contactless Interac purchase - 7043,Undefined
2/10/2020,contactless interac purchase - 9967,-11.6,,,TIM HORTONS #83,Contactless Interac purchase - 9967,Undefined
2/10/2020,contactless interac purchase - 0237,-34.84,,-68.3,PARADISO PASTRI,Contactless Interac purchase - 0237,Undefined
2/11/2020,contactless interac purchase - 2733,-16.97,,-51.33,ELSAFADI FOOD M,Contactless Interac purchase - 2733,Undefined
2/13/2020,misc payment clarke transpor,,-4630.8,,,Misc Payment CLARKE TRANSPOR,Undefined
2/13/2020,interac purchase - 7819 shell flying J,-300,,,,Interac purchase - 7819 SHELL FLYING J,Fuel costs
2/13/2020,contactless interac purchase - 5127,-17.13,,-4365,REAL CDN SUPERS,Contactless Interac purchase - 5127,Undefined
2/14/2020,interac purchase - 3307 real cdn supers,-35.57,,,,Interac purchase - 3307 REAL CDN SUPERS,Undefined
2/14/2020,interac purchase - 1610 lavish salon &,-42,,-4287.43,,Interac purchase - 1610 LAVISH SALON &,Undefined
2/17/2020,e-transfer received g.s.b. trucking inc.,,-2493.42,,,e-Transfer received G.S.B. TRUCKING INC.,Undefined
2/17/2020,e-transfer sent bashir,-2000,,-4780.85,,e-Transfer sent Bashir,Undefined
2/17/2020,interac purchase - 5547 city truck stop,-35.65,,,,Interac purchase - 5547 CITY TRUCK STOP,Undefined
2/17/2020,interac purchase - 1035 city truck stop,-566.01,,,,Interac purchase - 1035 CITY TRUCK STOP,Undefined
2/17/2020,contactless interac purchase - 0201,-2.09,,,TIM HORTONS #24,Contactless Interac purchase - 0201,Undefined
2/17/2020,contactless interac purchase - 6095,-13,,,PARADISO PASTRI,Contactless Interac purchase - 6095,Undefined
2/17/2020,contactless interac purchase - 5474,-32.44,,,REAL CDN SUPERS,Contactless Interac purchase - 5474,Undefined
2/17/2020,online transfer sent - 7731 khaled alardud,-400,,,,Online transfer sent - 7731 KHALED ALARDUD,Undefined
2/17/2020,online banking transfer - 7728,-2241.36,,-1490.3,,Online Banking transfer - 7728,Undefined
2/18/2020,contactless interac purchase - 8874,-2.09,,,TIM HORTONS #83,Contactless Interac purchase - 8874,Undefined
2/18/2020,contactless interac purchase - 0842,-12.59,,-1475.62,STAPLES #244,Contactless Interac purchase - 0842,Undefined
2/19/2020,contactless interac purchase - 4434,-43.23,,,ELSAFADI MEDITE,Contactless Interac purchase - 4434,Undefined
2/19/2020,contactless interac purchase - 6667,-63,,,XIAO PING FOOT,Contactless Interac purchase - 6667,Undefined
2/19/2020,insurance cooperators csi,-279.84,,-1089.55,,Insurance Cooperators CSI,Undefined
2/20/2020,misc payment clarke transpor,,-3104.03,,,Misc Payment CLARKE TRANSPOR,Undefined
2/20/2020,interac purchase - 2600 shell flying J,-9.89,,,,Interac purchase - 2600 SHELL FLYING J,Fuel costs
2/20/2020,contactless interac purchase - 7176,-9.11,,-4174.58,TIM HORTONS #83,Contactless Interac purchase - 7176,Undefined
2/21/2020,e-transfer sent bashir,-1000,,-3174.58,,e-Transfer sent Bashir,Undefined
2/21/2020,atm withdrawal - ei313522,-480,,,,ATM withdrawal - EI313522,Undefined
2/21/2020,interac purchase - 9128 shell c11994,-61.36,,-2633.22,,Interac purchase - 9128 SHELL C11994,Fuel costs
2/24/2020,contactless interac purchase - 2629,-4.18,,,TIM HORTONS #34,Contactless Interac purchase - 2629,Undefined
2/24/2020,contactless interac purchase - 5736,-8.36,,,REAL CDN SUPERS,Contactless Interac purchase - 5736,Undefined
2/24/2020,contactless interac purchase - 9656,-10.67,,,ELSAFADI FOOD M,Contactless Interac purchase - 9656,Undefined
2/24/2020,contactless interac purchase - 2402,-20,,,PARADISO PASTRI,Contactless Interac purchase - 2402,Undefined
2/24/2020,contactless interac purchase - 5342,-21,,-2569.01,THE BEDOUINS RE,Contactless Interac purchase - 5342,Undefined
2/25/2020,interac purchase - 8241 turquaz kebab H,-32.5,,,,Interac purchase - 8241 TURQUAZ KEBAB H,Undefined
2/25/2020,contactless interac purchase - 2714,-4.48,,-2532.03,TIM HORTONS #16,Contactless Interac purchase - 2714,Undefined
2/27/2020,misc payment clarke transpor,,-3782.94,,,Misc Payment CLARKE TRANSPOR,Undefined
2/27/2020,interac purchase - 7147 shell flying J,-200,,,,Interac purchase - 7147 SHELL FLYING J,Fuel costs
2/27/2020,contactless interac purchase - 0672,-11.87,,-6103.1,REAL CDN SUPERS,Contactless Interac purchase - 0672,Undefined
7/28/2020,interac purchase - 0174 tim hortons,-12.22,,,,Interac purchase - 0174 TIM HORTONS #11,Meals and entertainment
7/28/2020,interac purchase - 1199 creit esso,-60,,-250.7,,Interac purchase - 1199 CREIT ESSO,Fuel costs
7/30/2020,misc payment clarke transpor,,-1339.81,,,Misc Payment CLARKE TRANSPOR,Undefined
7/30/2020,atm withdrawal - ee578768,-200,,-1390.51,,ATM withdrawal - EE578768,Undefined
8/3/2020,misc payment pay-file fees,-2,,,,Misc Payment PAY-FILE FEES,Undefined
8/3/2020,auto insurance millennium ins,-207.37,,,,Auto Insurance MILLENNIUM INS,Undefined
8/3/2020,insurance cooperators csi,-420.64,,-760.5,,Insurance Cooperators CSI,Undefined
8/3/2020,monthly fee,-5,,,,Monthly fee,Undefined
8/3/2020,regular transaction fee 1 dr 2.50,-2.5,,-753,,Regular transaction fee 1 Dr  2.50,Undefined
8/4/2020,interac purchase - 0660 c01 dit170st-o,-165.77,,-587.23,,Interac purchase - 0660 C01 DIT(170ST-O,Undefined
8/6/2020,misc payment clarke transpor,,-1987.64,,,Misc Payment CLARKE TRANSPOR,Undefined
8/6/2020,interac purchase - 0705 veggie palace,-2.65,,-2572.22,,Interac purchase - 0705 VEGGIE PALACE,Undefined
8/7/2020,e-transfer received nismah painters ltd.,,-1000,-3572.22,,e-Transfer received NISMAH PAINTERS LTD.,Undefined
8/10/2020,e-transfer received rachid boudlal,,-100,,,e-Transfer received RACHID BOUDLAL,Undefined
8/10/2020,e-transfer received borama trucking ltd.,,-500,-4172.22,,e-Transfer received BORAMA TRUCKING LTD.,Undefined
8/10/2020,atm withdrawal - ei311320,-100,,,,ATM withdrawal - EI311320,Undefined
8/10/2020,interac purchase - 8333 turquaz kebab H,-23.05,,,,Interac purchase - 8333 TURQUAZ KEBAB H,Undefined
8/10/2020,interac purchase - 0512 yellowhd husky,-30,,,,Interac purchase - 0512 YELLOWHD HUSKY,Fuel costs
8/10/2020,interac purchase - 1703 edmonton fadez,-32.5,,-3986.67,,Interac purchase - 1703 EDMONTON FADEZ,Undefined
8/11/2020,interac purchase - 7698 shell flying J,-15.73,,-3970.94,,Interac purchase - 7698 SHELL FLYING J,Fuel costs
8/12/2020,online transfer sent - 7219 khaled alardud,-300,,-3670.94,,Online transfer sent - 7219 KHALED ALARDUD,Undefined
8/13/2020,misc payment clarke transpor,,-1706.76,,,Misc Payment CLARKE TRANSPOR,Undefined
8/13/2020,interac purchase - 3210 shell c22576,-5.25,,,,Interac purchase - 3210 SHELL C22576,Fuel costs
8/13/2020,interac purchase - 9484 save meat an,-40.74,,,,Interac purchase - 9484 SAVE ON MEAT AN,Undefined
8/13/2020,online banking transfer - 1510,-1520.01,,-3811.7,,Online Banking transfer - 1510,Undefined
8/17/2020,atm deposit - ed760484,,-10000,,,ATM deposit - ED760484,Undefined
8/17/2020,e-transfer received harpreet,,-415,-14226.7,,e-Transfer received Harpreet,Undefined
8/17/2020,interac purchase - 5706 tim hortons,-6.47,,,,Interac purchase - 5706 TIM HORTONS #42,Meals and entertainment
8/17/2020,interac purchase - 6088 first truck cen,-9.24,,,,Interac purchase - 6088 FIRST TRUCK CEN,Undefined
8/17/2020,interac purchase - 3119 paradiso pastri,-20,,,,Interac purchase - 3119 PARADISO PASTRI,Meals and entertainment
8/17/2020,interac purchase - 4187 real cdn supers,-24.85,,,,Interac purchase - 4187 REAL CDN SUPERS,Undefined
8/17/2020,interac purchase - 2911 esso 7-eleven 3,-30,,,,Interac purchase - 2911 ESSO 7-ELEVEN 3,Fuel costs
8/17/2020,interac purchase - 7194 city truck stop,-31.5,,,,Interac purchase - 7194 CITY TRUCK STOP,Undefined
8/17/2020,interac purchase - 3660 city truck stop,-31.71,,,,Interac purchase - 3660 CITY TRUCK STOP,Undefined
8/17/2020,interac purchase - 6798 mobil@ - 1772,-60,,,,Interac purchase - 6798 MOBIL@ - 1772,Fuel costs
8/17/2020,br to br - 1599,-3987.81,,,,BR TO BR - 1599,Undefined
8/17/2020,online banking transfer - 8076,-5.45,,-10019.67,,Online Banking transfer - 8076,Undefined
8/19/2020,online transfer sent - 0209 khaled alardud,-1500,,,,Online transfer sent - 0209 KHALED ALARDUD,Undefined
8/19/2020,insurance cooperators csi,-290.5,,-8229.17,,Insurance Cooperators CSI,Undefined
8/20/2020,misc payment clarke transpor,,-2601.64,,,Misc Payment CLARKE TRANSPOR,Undefined
8/20/2020,interac purchase - 8987 tim hortons,-2.09,,,,Interac purchase - 8987 TIM HORTONS #16,Meals and entertainment
8/20/2020,interac purchase - 5348 tim hortons,-3.13,,,,Interac purchase - 5348 TIM HORTONS #27,Meals and entertainment
8/20/2020,interac purchase - 7588 tim hortons,-5.85,,,,Interac purchase - 7588 TIM HORTONS #16,Meals and entertainment
8/20/2020,interac purchase - 1525 shell flying J,-7.49,,,,Interac purchase - 1525 SHELL FLYING J,Fuel costs
8/20/2020,interac purchase - 7231 city truck stop,-331.34,,,,Interac purchase - 7231 CITY TRUCK STOP,Undefined
8/20/2020,br to br - 1599,-9440.2,,-1040.71,,BR TO BR - 1599,Undefined
8/24/2020,atm withdrawal - ei313620,-500,,,,ATM withdrawal - EI313620,Undefined
8/24/2020,interac purchase - 2002 mediterranean P,-18.5,,,,Interac purchase - 2002 MEDITERRANEAN P,Undefined
8/24/2020,cash withdrawal,-80,,-442.21,,Cash withdrawal,Undefined
8/27/2020,misc payment clarke transpor,,-2719.67,,,Misc Payment CLARKE TRANSPOR,Undefined
8/27/2020,interac purchase - 5374 first truck cen,-94.92,,-3066.96,,Interac purchase - 5374 FIRST TRUCK CEN,Undefined
6/29/2020,interac purchase refund - 9336 northtown regis,,-93,,,Interac purchase refund - 9336 NORTHTOWN REGIS,Undefined
6/29/2020,e-transfer received abdinasir,,-750,-5800.08,,e-Transfer received abdinasir,Undefined
6/29/2020,interac purchase - 6999 northtown regis,-121,,,,Interac purchase - 6999 NORTHTOWN REGIS,Undefined
6/29/2020,interac purchase - 3442 allspec diesel,-262.5,,,,Interac purchase - 3442 ALLSPEC DIESEL,Undefined
6/29/2020,contactless interac purchase - 4128,-2.09,,,TIM HORTONS #16,Contactless Interac purchase - 4128,Undefined
6/29/2020,contactless interac purchase - 9991,-3.68,,,BINGO PIZZA DON,Contactless Interac purchase - 9991,Undefined
6/29/2020,contactless interac purchase - 9359,-5.23,,,TIM HORTONS #75,Contactless Interac purchase - 9359,Undefined
6/29/2020,contactless interac purchase - 7119,-10.5,,,SPECTRUM TEL,Contactless Interac purchase - 7119,Undefined
6/29/2020,contactless interac purchase - 3182,-11.29,,,T&T SUPERMARKET,Contactless Interac purchase - 3182,Undefined
6/29/2020,contactless interac purchase - 4643,-12.23,,,TIM HORTONS #16,Contactless Interac purchase - 4643,Undefined
6/29/2020,contactless interac purchase - 1435,-18.64,,,PARADISO PASTRI,Contactless Interac purchase - 1435,Undefined
6/29/2020,contactless interac purchase - 1456,-35.05,,,BINGO PIZZA DON,Contactless Interac purchase - 1456,Undefined
6/29/2020,contactless interac purchase - 6320,-57.73,,,REAL CDN SUPERS,Contactless Interac purchase - 6320,Undefined
6/29/2020,contactless interac purchase - 7341 karim meats,-75,,,,Contactless Interac purchase - 7341 KARIM MEATS,Undefined
6/29/2020,online transfer sent - 9823 khaled alardud,-170,,,,Online transfer sent - 9823 KHALED ALARDUD,Undefined
6/29/2020,online banking transfer - 2897,-340.12,,-4675.02,,Online Banking transfer - 2897,Undefined
6/30/2020,interac purchase - 7999 northtown regis,-93,,,,Interac purchase - 7999 NORTHTOWN REGIS,Undefined
6/30/2020,contactless interac purchase - 0594,-2.09,,,TIM HORTONS #23,Contactless Interac purchase - 0594,Undefined
6/30/2020,contactless interac purchase - 2341,-40,,,SAVE ON MEAT AN,Contactless Interac purchase - 2341,Undefined
6/30/2020,contactless interac purchase - 6673,-60.83,,-4479.1,ELSAFADI MEDITE,Contactless Interac purchase - 6673,Undefined
7/2/2020,misc payment clarke transpor,,-3038.63,,,Misc Payment CLARKE TRANSPOR,Undefined
7/2/2020,interac purchase - 0592 shell flying J,-500,,,,Interac purchase - 0592 SHELL FLYING J,Fuel costs
7/2/2020,misc payment pay-file fees,-2,,,,Misc Payment PAY-FILE FEES,Undefined
7/2/2020,auto insurance millennium ins,-207.33,,,,Auto Insurance MILLENNIUM INS,Undefined
7/2/2020,insurance cooperators csi,-420.64,,-6387.76,,Insurance Cooperators CSI,Undefined
7/2/2020,monthly fee,-5,,,,Monthly fee,Undefined
7/2/2020,regular transaction fee 1 dr 2.50,-2.5,,-6380.26,,Regular transaction fee 1 Dr  2.50,Undefined
7/3/2020,contactless interac purchase - 3506,-5.74,,-6374.52,TIM HORTONS #83,Contactless Interac purchase - 3506,Undefined
7/6/2020,interac purchase - 0671 the home depot,-138.61,,,,Interac purchase - 0671 THE HOME DEPOT,Supplies
7/6/2020,interac purchase - 0869 save meat an,-173.78,,,,Interac purchase - 0869 SAVE ON MEAT AN,Undefined
7/6/2020,contactless interac purchase - 6005 lazio 97,-3.68,,,,Contactless Interac purchase - 6005 LAZIO 97,Undefined
7/6/2020,contactless interac purchase - 4420 lazio 97,-7.35,,,,Contactless Interac purchase - 4420 LAZIO 97,Undefined
7/6/2020,contactless interac purchase - 7818,-18.55,,,ELSAFADI FOOD M,Contactless Interac purchase - 7818,Undefined
7/6/2020,contactless interac purchase - 3583,-47.52,,,ELSAFADI MEDITE,Contactless Interac purchase - 3583,Undefined
7/6/2020,online transfer sent - 8779 khaled alardud,-150,,-5835.03,,Online transfer sent - 8779 KHALED ALARDUD,Undefined
7/7/2020,interac purchase refund - 9043 the home depot,,-50.38,-5885.41,,Interac purchase refund - 9043 THE HOME DEPOT,Supplies
7/7/2020,interac purchase - 1234 the home depot,-6.8,,,,Interac purchase - 1234 THE HOME DEPOT,Supplies
7/7/2020,interac purchase - 3196 shell flying J,-400,,-5478.61,,Interac purchase - 3196 SHELL FLYING J,Fuel costs
7/8/2020,contactless interac purchase - 6409,-7.2,,-5471.41,TIM HORTONS #24,Contactless Interac purchase - 6409,Undefined
7/9/2020,misc payment clarke transpor,,-2268.24,-7739.65,,Misc Payment CLARKE TRANSPOR,Undefined
7/10/2020,online banking transfer - 5365,-426.9,,-7312.75,,Online Banking transfer - 5365,Undefined
7/13/2020,e-transfer sent abudallha,-2000,,,,e-Transfer sent abudallha,Undefined
7/13/2020,e-transfer sent abudallha,-2000,,-3312.75,,e-Transfer sent abudallha,Undefined
7/13/2020,atm withdrawal - ea568244,-500,,,,ATM withdrawal - EA568244,Undefined
7/13/2020,interac purchase - 0485 tim hortons,-2.09,,,,Interac purchase - 0485 TIM HORTONS #24,Meals and entertainment
7/13/2020,interac purchase - 1920 shell flying J,-9.44,,,,Interac purchase - 1920 SHELL FLYING J,Fuel costs
7/13/2020,interac purchase - 7616 first truck cen,-13.71,,,,Interac purchase - 7616 FIRST TRUCK CEN,Undefined
7/13/2020,interac purchase - 2939 costco gas w154,-74.07,,,,Interac purchase - 2939 COSTCO GAS W154,Fuel costs
7/13/2020,interac purchase - 8059 wholesale liqui,-104.95,,,,Interac purchase - 8059 WHOLESALE LIQUI,Undefined
7/13/2020,interac purchase - 2953 costco wholesal,-278.89,,-2329.6,,Interac purchase - 2953 COSTCO WHOLESAL,Supplies
7/14/2020,interac purchase - 4667 tim hortons,-2.08,,-2327.52,,Interac purchase - 4667 TIM HORTONS #29,Meals and entertainment
7/15/2020,e-transfer sent nagi,-260,,-2067.52,,e-Transfer sent nagi,Undefined
7/15/2020,interac purchase - 4714 tim hortons,-3.13,,-2064.39,,Interac purchase - 4714 TIM HORTONS #11,Meals and entertainment
7/16/2020,misc payment clarke transpor,,-2670.84,,,Misc Payment CLARKE TRANSPOR,Undefined
7/16/2020,interac purchase - 4240 donair land,-35,,,,Interac purchase - 4240 DONAIR LAND,Meals and entertainment
7/16/2020,interac purchase - 2595 jiffy lube,-141.9,,,,Interac purchase - 2595 JIFFY LUBE,Repairs and maintenance - vehicles
7/16/2020,interac purchase - 0666 shell flying J,-400,,-4158.33,,Interac purchase - 0666 SHELL FLYING J,Fuel costs
7/17/2020,interac purchase - 2977 tim hortons,-7.89,,,,Interac purchase - 2977 TIM HORTONS #39,Meals and entertainment
7/17/2020,interac purchase - 0481 mcdonalds,-37.76,,,,Interac purchase - 0481 MCDONALD'S #402,Meals and entertainment
7/17/2020,interac purchase - 8488 petro-canada,-39.99,,,,Interac purchase - 8488 PETRO-CANADA,Fuel costs
7/17/2020,interac purchase - 1312 shell c10381,-41.74,,-4030.95,,Interac purchase - 1312 SHELL C10381,Fuel costs
7/20/2020,interac purchase - 7051 tim hortons,-6.78,,,,Interac purchase - 7051 TIM HORTONS #36,Meals and entertainment
7/20/2020,interac purchase - 1544 banff gondola,-30,,,,Interac purchase - 1544 BANFF GONDOLA,Undefined
7/20/2020,interac purchase - 7592 mcdonalds,-36.04,,,,Interac purchase - 7592 MCDONALD'S #231,Meals and entertainment
7/20/2020,interac purchase - 4364 husky lake loui,-38.22,,,,Interac purchase - 4364 HUSKY LAKE LOUI,Fuel costs
7/20/2020,interac purchase - 6179 banff gondola,-147,,,,Interac purchase - 6179 BANFF GONDOLA,Undefined
7/20/2020,insurance cooperators csi,-290.5,,-3482.41,,Insurance Cooperators CSI,Undefined
7/21/2020,atm deposit - ei318300,,-1350,-4832.41,,ATM deposit - EI318300,Undefined
7/22/2020,interac purchase - 9502 mobil@ - 1772,-75.61,,,,Interac purchase - 9502 MOBIL@ - 1772,Fuel costs
7/22/2020,interac purchase - 9172 mobil@ - 1772,-100,,-4656.8,,Interac purchase - 9172 MOBIL@ - 1772,Fuel costs
7/23/2020,misc payment clarke transpor,,-3427.86,,,Misc Payment CLARKE TRANSPOR,Undefined
7/23/2020,online transfer sent - 3928 khaled alardud,-1000,,,,Online transfer sent - 3928 KHALED ALARDUD,Undefined
7/23/2020,online banking transfer - 2282,-677.52,,-6407.14,,Online Banking transfer - 2282,Undefined
7/24/2020,interac purchase - 0751 princess auto 0,-31.48,,,,Interac purchase - 0751 PRINCESS AUTO 0,Undefined
7/24/2020,cash withdrawal,-6048.45,,-327.21,,Cash withdrawal,Undefined
7/27/2020,interac purchase - 5253 quality dry cle,-4.29,,-322.92,,Interac purchase - 5253 QUALITY DRY CLE,Undefined
3/30/2020,interac purchase - 5088 shell flying J,-1.61,,,,Interac purchase - 5088 SHELL FLYING J,Fuel costs
3/30/2020,interac purchase - 5477 shell c11994,-32.61,,,,Interac purchase - 5477 SHELL C11994,Fuel costs
3/30/2020,interac purchase - 7549 shell flying J,-400,,,,Interac purchase - 7549 SHELL FLYING J,Fuel costs
3/30/2020,contactless interac purchase - 4607,-24,,,CEDAR SWEETS LT,Contactless Interac purchase - 4607,Undefined
3/30/2020,online banking transfer - 8239,-164.29,,-1442.2,,Online Banking transfer - 8239,Undefined
3/31/2020,interac purchase - 8777 shell flying J,-5.37,,-1436.83,,Interac purchase - 8777 SHELL FLYING J,Fuel costs
4/1/2020,interac purchase - 2303 fort garry indu,-220.5,,,,Interac purchase - 2303 FORT GARRY INDU,Undefined
4/1/2020,misc payment pay-file fees,-2,,,,Misc Payment PAY-FILE FEES,Undefined
4/1/2020,auto insurance millennium ins,-197.33,,,,Auto Insurance MILLENNIUM INS,Undefined
4/1/2020,insurance cooperators csi,-417.88,,-599.12,,Insurance Cooperators CSI,Undefined
4/1/2020,monthly fee,-5,,-594.12,,Monthly fee,Undefined
4/2/2020,e-transfer received christel mantla,,-220,-814.12,,e-Transfer received CHRISTEL MANTLA,Undefined
4/2/2020,misc payment clarke transpor,,-1970.75,,,Misc Payment CLARKE TRANSPOR,Undefined
4/2/2020,interac purchase - 7834 shell flying J,-8.7,,-2776.17,,Interac purchase - 7834 SHELL FLYING J,Fuel costs
4/3/2020,interac purchase - 3525 shell flying J,-3.34,,,,Interac purchase - 3525 SHELL FLYING J,Fuel costs
4/3/2020,interac purchase - 7107 shell flying J,-300,,,,Interac purchase - 7107 SHELL FLYING J,Fuel costs
4/3/2020,contactless interac purchase - 8466,-18.17,,-2454.66,FORT GARRY INDU,Contactless Interac purchase - 8466,Undefined
4/6/2020,atm withdrawal - ej494892,-80,,-2374.66,,ATM withdrawal - EJ494892,Undefined
4/7/2020,contactless interac purchase - 8406,-6.9,,-2367.76,TIM HORTONS #16,Contactless Interac purchase - 8406,Undefined
4/8/2020,contactless interac purchase - 3807,-9.42,,-2358.34,MCDONALD'S #626,Contactless Interac purchase - 3807,Undefined
4/9/2020,misc payment clarke transpor,,-2371.36,,,Misc Payment CLARKE TRANSPOR,Undefined
4/9/2020,interac purchase - 6083 shell flying J,-300,,-4429.7,,Interac purchase - 6083 SHELL FLYING J,Fuel costs
4/13/2020,e-transfer sent fwaziy,-2000,,-2429.7,,e-Transfer sent fwaziy,Undefined
4/13/2020,interac purchase - 9387 mobil@ - 1772,-44.39,,-2385.31,,Interac purchase - 9387 MOBIL@ - 1772,Fuel costs
4/15/2020,interac purchase - 4523 shell flying J,-300,,-2085.31,,Interac purchase - 4523 SHELL FLYING J,Fuel costs
4/16/2020,misc payment clarke transpor,,-1449.83,,,Misc Payment CLARKE TRANSPOR,Undefined
4/16/2020,interac purchase - 8266 sq global tax,-787.5,,-2747.64,,Interac purchase - 8266 SQ *GLOBAL TAX,Undefined
4/17/2020,interac purchase - 6723 petro-canada,-36.06,,,,Interac purchase - 6723 PETRO-CANADA,Fuel costs
4/17/2020,br to br - 5429,-1326,,-1385.58,,BR TO BR - 5429,Undefined
4/20/2020,atm deposit - ei311519,,-3187,,,ATM deposit - EI311519,Undefined
4/20/2020,e-transfer received borama trucking ltd.,,-281,,,e-Transfer received BORAMA TRUCKING LTD.,Undefined
4/20/2020,e-transfer received,,-500,,NADYA ABOBAKER AL MEDGHIW,e-Transfer received,Undefined
4/20/2020,e-transfer sent fwaziy,-270,,,,e-Transfer sent fwaziy,Undefined
4/20/2020,e-transfer sent fwaziy,-1600,,-3483.58,,e-Transfer sent fwaziy,Undefined
4/20/2020,contactless interac purchase - 2400,-2.02,,,TIM HORTONS #16,Contactless Interac purchase - 2400,Undefined
4/20/2020,contactless interac purchase - 9130,-11.12,,,MCDONALD'S #626,Contactless Interac purchase - 9130,Undefined
4/20/2020,insurance cooperators csi,-279.76,,-3190.68,,Insurance Cooperators CSI,Undefined
4/23/2020,e-transfer sent fwaziy,-2000,,-1190.68,,e-Transfer sent fwaziy,Undefined
4/23/2020,misc payment clarke transpor,,-1969.32,,,Misc Payment CLARKE TRANSPOR,Undefined
4/23/2020,online banking transfer - 6266,-408.8,,-2751.2,,Online Banking transfer - 6266,Undefined
4/27/2020,contactless interac purchase - 9448,-2.39,,-2748.81,TIM HORTONS #27,Contactless Interac purchase - 9448,Undefined
5/28/2020,misc payment clarke transpor,,-2397.09,,,Misc Payment CLARKE TRANSPOR,Undefined
5/28/2020,cash withdrawal,-13658.5,,-14184.04,,Cash withdrawal,Undefined
5/29/2020,interac purchase - 1553 shell flying J,-11.52,,,,Interac purchase - 1553 SHELL FLYING J,Fuel costs
5/29/2020,interac purchase - 5151 shell flying J,-600,,-13572.52,,Interac purchase - 5151 SHELL FLYING J,Fuel costs
6/1/2020,interac purchase - 3375 turquaz kebab H,-65.99,,,,Interac purchase - 3375 TURQUAZ KEBAB H,Undefined
6/1/2020,interac purchase - 6448 davidson travel,-329.7,,,,Interac purchase - 6448 DAVIDSON TRAVEL,Undefined
6/1/2020,interac purchase - 2942 allspec diesel,-1097.25,,,,Interac purchase - 2942 ALLSPEC DIESEL,Undefined
6/1/2020,contactless interac purchase - 2829,-2.21,,,TIM HORTONS #63,Contactless Interac purchase - 2829,Undefined
6/1/2020,contactless interac purchase - 5774,-2.43,,,TIM HORTONS #63,Contactless Interac purchase - 5774,Undefined
6/1/2020,contactless interac purchase - 8933,-4.59,,,TIM HORTONS #11,Contactless Interac purchase - 8933,Undefined
6/1/2020,contactless interac purchase - 5753,-6.47,,,DAVIDSON TRAVEL,Contactless Interac purchase - 5753,Undefined
6/1/2020,contactless interac purchase - 7847,-12,,,A. ALBERTA REGI,Contactless Interac purchase - 7847,Undefined
6/1/2020,contactless interac purchase - 6142,-56,,,A. ALBERTA REGI,Contactless Interac purchase - 6142,Undefined
6/1/2020,contactless interac purchase - 9486,-63,,,CITY TRUCK STOP,Contactless Interac purchase - 9486,Undefined
6/1/2020,online banking transfer - 0166,-392.82,,,,Online Banking transfer - 0166,Undefined
6/1/2020,misc payment pay-file fees,-2,,,,Misc Payment PAY-FILE FEES,Undefined
6/1/2020,auto insurance millennium ins,-197.33,,,,Auto Insurance MILLENNIUM INS,Undefined
6/1/2020,insurance cooperators csi,-451.84,,-10888.89,,Insurance Cooperators CSI,Undefined
6/1/2020,monthly fee,-5,,,,Monthly fee,Undefined
6/1/2020,regular transaction fee 6 drs 2.50,-15,,-10868.89,,Regular transaction fee 6 Drs  2.50,Undefined
6/2/2020,interac purchase - 5362 shell flying J,-50,,,,Interac purchase - 5362 SHELL FLYING J,Fuel costs
6/2/2020,interac purchase - 4110 shell flying J,-400,,,,Interac purchase - 4110 SHELL FLYING J,Fuel costs
6/2/2020,contactless interac purchase - 7588,-2.09,,,TIM HORTONS #11,Contactless Interac purchase - 7588,Undefined
6/2/2020,contactless interac purchase - 1559,-49.31,,-10367.49,KABSA THE ULTIM,Contactless Interac purchase - 1559,Undefined
6/3/2020,interac purchase - 3216 shell flying J,-1.69,,,,Interac purchase - 3216 SHELL FLYING J,Fuel costs
6/3/2020,interac purchase - 9577 the home depot,-6.93,,,,Interac purchase - 9577 THE HOME DEPOT,Supplies
6/3/2020,contactless interac purchase - 2545,-48.3,,-10310.57,FORT GARRY INDU,Contactless Interac purchase - 2545,Undefined
6/4/2020,e-transfer sent fix tire,-1760,,-8550.57,,e-Transfer sent fix tire,Undefined
6/4/2020,misc payment clarke transpor,,-1276.27,,,Misc Payment CLARKE TRANSPOR,Undefined
6/4/2020,online banking transfer - 8838,-198.08,,-9628.76,,Online Banking transfer - 8838,Undefined
6/5/2020,interac purchase - 6451 fort garry indu,-126.42,,,,Interac purchase - 6451 FORT GARRY INDU,Undefined
6/5/2020,contactless interac purchase - 3744,-38.83,,-9463.51,MONA'S PIZZA,Contactless Interac purchase - 3744,Undefined
6/8/2020,interac purchase - 1240 shell flying J,-300,,,,Interac purchase - 1240 SHELL FLYING J,Fuel costs
6/8/2020,contactless interac purchase - 5312,-3.34,,-9160.17,TIM HORTONS #24,Contactless Interac purchase - 5312,Undefined
6/10/2020,interac purchase - 3976 shell c11994,-73.14,,,,Interac purchase - 3976 SHELL C11994,Fuel costs
6/10/2020,interac purchase - 2012 allspec diesel,-220.5,,,,Interac purchase - 2012 ALLSPEC DIESEL,Undefined
6/10/2020,interac purchase - 0458 c01 dit170st-o,-494,,,,Interac purchase - 0458 C01 DIT(170ST-O,Undefined
6/10/2020,interac purchase - 8021 c01 dit170st-o,-606.56,,,,Interac purchase - 8021 C01 DIT(170ST-O,Undefined
6/10/2020,contactless interac purchase - 5422,-81.9,,-7684.07,THE BEDOUINS RE,Contactless Interac purchase - 5422,Undefined
6/11/2020,misc payment clarke transpor,,-2512.54,-10196.61,,Misc Payment CLARKE TRANSPOR,Undefined
6/12/2020,interac purchase - 2033 real cdn supers,-232.52,,,,Interac purchase - 2033 REAL CDN SUPERS,Undefined
6/12/2020,contactless interac purchase - 2412,-19.06,,,REAL CDN SUPERS,Contactless Interac purchase - 2412,Undefined
6/12/2020,contactless interac purchase - 5525,-43.94,,,DOLLARAMA #409,Contactless Interac purchase - 5525,Undefined
6/12/2020,contactless interac purchase - 4780,-82.38,,-9818.71,ELSAFADI FOOD M,Contactless Interac purchase - 4780,Undefined
6/15/2020,e-transfer received,,-900,,BALCHA TRADING SERVICES INC.,e-Transfer received,Undefined
6/15/2020,e-transfer sent sami,-515,,-10203.71,,e-Transfer sent sami,Undefined
6/15/2020,interac purchase - 6379 part source,-159.58,,,,Interac purchase - 6379 PART SOURCE #72,Undefined
6/15/2020,contactless interac purchase - 3159,-9.73,,,SHELL C11994,Contactless Interac purchase - 3159,Undefined
6/15/2020,contactless interac purchase - 3051,-17.95,,,SHELL C11994,Contactless Interac purchase - 3051,Undefined
6/15/2020,contactless interac purchase - 9147,-69.71,,-9946.74,CANADIAN TIRE #,Contactless Interac purchase - 9147,Undefined
6/16/2020,interac purchase - 4241 shell flying J,-400,,,,Interac purchase - 4241 SHELL FLYING J,Fuel costs
6/16/2020,contactless interac purchase - 7821,-2.4,,,TIM HORTONS #24,Contactless Interac purchase - 7821,Undefined
6/16/2020,contactless interac purchase - 6993,-39.9,,-9504.44,THE BEDOUINS RE,Contactless Interac purchase - 6993,Undefined
6/17/2020,interac purchase - 9919 real cdn supers,-131.48,,,,Interac purchase - 9919 REAL CDN SUPERS,Undefined
6/17/2020,interac purchase - 2629 shell flying J,-300,,,,Interac purchase - 2629 SHELL FLYING J,Fuel costs
6/17/2020,contactless interac purchase - 7791,-5.25,,,FAS GAS REFINER,Contactless Interac purchase - 7791,Undefined
6/17/2020,contactless interac purchase - 3320,-20,,-9047.71,PARADISO PASTRI,Contactless Interac purchase - 3320,Undefined
6/18/2020,misc payment clarke transpor,,-2793.49,-11841.2,,Misc Payment CLARKE TRANSPOR,Undefined
6/19/2020,cash withdrawal,-5500,,,,Cash withdrawal,Undefined
6/19/2020,online transfer sent - 8713 khaled alardud,-2000,,,,Online transfer sent - 8713 KHALED ALARDUD,Undefined
6/19/2020,insurance cooperators csi,-290.5,,-4050.7,,Insurance Cooperators CSI,Undefined
6/22/2020,interac purchase - 0680 turquaz kebab H,-2.63,,,,Interac purchase - 0680 TURQUAZ KEBAB H,Undefined
6/22/2020,interac purchase - 9489 turquaz kebab H,-69.14,,,,Interac purchase - 9489 TURQUAZ KEBAB H,Undefined
6/22/2020,interac purchase - 6961 shell c11994,-111.4,,,,Interac purchase - 6961 SHELL C11994,Fuel costs
6/22/2020,contactless interac purchase - 6264,-2.09,,,TIM HORTONS #11,Contactless Interac purchase - 6264,Undefined
6/22/2020,contactless interac purchase - 4955,-4.81,,,TIM HORTONS #16,Contactless Interac purchase - 4955,Undefined
6/22/2020,contactless interac purchase - 3858,-6.13,,,SHELL C11994,Contactless Interac purchase - 3858,Undefined
6/22/2020,contactless interac purchase - 9892,-17.95,,,SHELL C11994,Contactless Interac purchase - 9892,Undefined
6/22/2020,contactless interac purchase - 9790,-63,,,XIAO PING FOOT,Contactless Interac purchase - 9790,Undefined
6/22/2020,contactless interac purchase - 0315,-70.32,,-3703.23,WHOLESALE LIQUI,Contactless Interac purchase - 0315,Undefined
6/23/2020,interac purchase - 9557 shell c11994,-80.98,,,,Interac purchase - 9557 SHELL C11994,Fuel costs
6/23/2020,interac purchase - 8012 shell flying J,-400,,,,Interac purchase - 8012 SHELL FLYING J,Fuel costs
6/23/2020,contactless interac purchase - 5157,-12.8,,-3209.45,SHELL C11994,Contactless Interac purchase - 5157,Undefined
6/24/2020,interac purchase - 9512 turquaz kebab H,-45.57,,,,Interac purchase - 9512 TURQUAZ KEBAB H,Undefined
6/24/2020,contactless interac purchase - 2512,-98.21,,,C01 DIT(170ST-O,Contactless Interac purchase - 2512,Undefined
6/24/2020,online transfer sent - 7645 khaled alardud,-200,,-2865.67,,Online transfer sent - 7645 KHALED ALARDUD,Undefined
6/25/2020,misc payment clarke transpor,,-3878.04,,,Misc Payment CLARKE TRANSPOR,Undefined
6/25/2020,interac purchase - 0196 mobil@ - 1772,-30,,-6713.71,,Interac purchase - 0196 MOBIL@ - 1772,Fuel costs
6/26/2020,atm withdrawal - ei313946,-320,,,,ATM withdrawal - EI313946,Undefined
6/26/2020,interac purchase - 6109 turquaz kebab H,-40.85,,,,Interac purchase - 6109 TURQUAZ KEBAB H,Undefined
6/26/2020,interac purchase - 0351 the home depot,-60.29,,,,Interac purchase - 0351 THE HOME DEPOT,Supplies
6/26/2020,interac purchase - 6091 able tire edmon,-1333.4,,,,Interac purchase - 6091 ABLE TIRE EDMON,Undefined
6/26/2020,contactless interac purchase - 9937,-2.09,,-4957.08,TIM HORTONS #16,Contactless Interac purchase - 9937,Undefined
11/30/2020,atm deposit - ei319243,,-990,-7191.77,,ATM deposit - EI319243,Undefined
11/30/2020,interac purchase - 8233 tim hortons,-6.51,,,,Interac purchase - 8233 TIM HORTONS #11,Meals and entertainment
11/30/2020,interac purchase - 0503 shell flying J,-300,,,,Interac purchase - 0503 SHELL FLYING J,Fuel costs
11/30/2020,interac purchase - 0932 shell flying J,-300,,,,Interac purchase - 0932 SHELL FLYING J,Fuel costs
11/30/2020,online banking transfer - 9510,-268.05,,-6317.21,,Online Banking transfer - 9510,Undefined
12/1/2020,e-transfer sent bashir,-2000,,-4317.21,,e-Transfer sent Bashir,Undefined
12/1/2020,interac purchase - 9071 truckco mechani,-82.96,,,,Interac purchase - 9071 TRUCKCO MECHANI,Undefined
12/1/2020,online transfer sent - 8027 khaled alardud,-1000,,,,Online transfer sent - 8027 KHALED ALARDUD,Undefined
12/1/2020,misc payment pay-file fees,-2,,,,Misc Payment PAY-FILE FEES,Undefined
12/1/2020,auto insurance millennium ins,-194.25,,,,Auto Insurance MILLENNIUM INS,Undefined
12/1/2020,insurance cooperators csi,-989.27,,-2048.73,,Insurance Cooperators CSI,Undefined
12/1/2020,item returned unpaid s00814,-990,,,,Item returned unpaid S00814,Undefined
12/1/2020,monthly fee,-5,,,,Monthly fee,Undefined
12/1/2020,regular transaction fee 4 drs 2.50,-10,,-1043.73,,Regular transaction fee 4 Drs  2.50,Undefined
12/2/2020,interac purchase - 9814 esso 7-eleven 3,-100,,,,Interac purchase - 9814 ESSO 7-ELEVEN 3,Fuel costs
12/2/2020,online transfer sent - 5837 khaled alardud,-100,,,,Online transfer sent - 5837 KHALED ALARDUD,Undefined
12/2/2020,item returned unpaid fee,-7,,-836.73,,Item returned unpaid fee,Undefined
12/3/2020,e-transfer sent bashir,-1262,,425.27,,e-Transfer sent Bashir,Undefined
12/3/2020,misc payment clarke transpor,,-5108.57,,,Misc Payment CLARKE TRANSPOR,Undefined
12/3/2020,interac purchase - 2278 first truck cen,-18.52,,-4664.78,,Interac purchase - 2278 FIRST TRUCK CEN,Undefined
12/4/2020,interac purchase - 9446 petro-canada,-15.35,,-4649.43,,Interac purchase - 9446 PETRO-CANADA,Fuel costs
12/7/2020,e-transfer received cavnk5pj,,-70,,NADYA ABOBAKER AL MEDGHIW,e-Transfer received  CAVnK5Pj,Undefined
12/7/2020,e-transfer sent bashir,-1300,,-3419.43,,e-Transfer sent Bashir,Undefined
12/7/2020,deposit,,-2500,,,Deposit,Undefined
12/7/2020,atm withdrawal - ed215811,-145,,,,ATM withdrawal - ED215811,Undefined
12/7/2020,interac purchase - 5843 safeway gas bar,-9.36,,,,Interac purchase - 5843 SAFEWAY GAS BAR,Fuel costs
12/7/2020,interac purchase - 2336 turquaz kebab H,-28.3,,,,Interac purchase - 2336 TURQUAZ KEBAB H,Undefined
12/7/2020,interac purchase - 1304 petro-canada,-80,,-5656.77,,Interac purchase - 1304 PETRO-CANADA,Fuel costs
12/8/2020,interac purchase - 4194 tim hortons,-4.17,,,,Interac purchase - 4194 TIM HORTONS #74,Meals and entertainment
12/8/2020,interac purchase - 0590 shell flying J,-300,,,,Interac purchase - 0590 SHELL FLYING J,Fuel costs
12/8/2020,interac purchase - 5858 shell flying J,-300,,-5052.6,,Interac purchase - 5858 SHELL FLYING J,Fuel costs
12/9/2020,interac purchase - 3084 tim hortons,-2.09,,,,Interac purchase - 3084 TIM HORTONS #83,Meals and entertainment
12/9/2020,interac purchase - 5887 petro-canada,-3.99,,,,Interac purchase - 5887 PETRO-CANADA,Fuel costs
12/9/2020,online transfer sent - 2072 khaled alardud,-200,,,,Online transfer sent - 2072 KHALED ALARDUD,Undefined
12/9/2020,cheque - 999999,-3858.25,,-988.27,,Cheque - 999999,Undefined
12/10/2020,misc payment clarke transpor,,-4416.18,,,Misc Payment CLARKE TRANSPOR,Undefined
12/10/2020,interac purchase - 8056 ting massa,-73.5,,,,Interac purchase - 8056 TING TING MASSA,Undefined
12/10/2020,cheque - 999434,-3000,,-2330.95,,Cheque - 999434,Undefined
12/11/2020,interac purchase - 9441 save meat an,-33,,,,Interac purchase - 9441 SAVE ON MEAT AN,Undefined
12/11/2020,online banking transfer - 0526,-2053.38,,,,Online Banking transfer - 0526,Undefined
12/11/2020,chq printing fee chqdep order,-152.05,,-92.52,,Chq Printing Fee CHQ/DEP ORDER,Undefined
12/17/2020,misc payment clarke transpor,,-4198.52,,,Misc Payment CLARKE TRANSPOR,Undefined
12/17/2020,interac purchase - 1540 husky brandon P,-200,,-4091.04,,Interac purchase - 1540 HUSKY BRANDON P,Fuel costs
12/21/2020,interac purchase - 9933 shell c03403,-80.69,,,,Interac purchase - 9933 SHELL C03403,Fuel costs
12/21/2020,interac purchase - 1900 shell flying J,-400,,,,Interac purchase - 1900 SHELL FLYING J,Fuel costs
12/21/2020,insurance cooperators csi,-487.34,,-3123.01,,Insurance Cooperators CSI,Undefined
12/24/2020,misc payment clarke transpor,,-5196.55,,,Misc Payment CLARKE TRANSPOR,Undefined
12/24/2020,online banking transfer - 2664,-1499.37,,-6820.19,,Online Banking transfer - 2664,Undefined
10/28/2020,interac purchase - 8981 veggie palace,-13,,,,Interac purchase - 8981 VEGGIE PALACE,Undefined
10/28/2020,interac purchase - 2498 mcdonalds,-15.29,,,,Interac purchase - 2498 MCDONALD'S #407,Meals and entertainment
10/28/2020,interac purchase - 7804 save meat an,-51.48,,,,Interac purchase - 7804 SAVE ON MEAT AN,Undefined
10/28/2020,interac purchase - 9724 shell flying J,-300,,,,Interac purchase - 9724 SHELL FLYING J,Fuel costs
10/28/2020,online transfer sent - 2219 khaled alardud,-100,,-1259.24,,Online transfer sent - 2219 KHALED ALARDUD,Undefined
10/29/2020,misc payment clarke transpor,,-3590.88,-4850.12,,Misc Payment CLARKE TRANSPOR,Undefined
10/30/2020,e-transfer received borama trucking ltd.,,-2171.25,-7021.37,,e-Transfer received BORAMA TRUCKING LTD.,Undefined
10/30/2020,interac purchase - 2382 shell flying J,-300,,-6721.37,,Interac purchase - 2382 SHELL FLYING J,Fuel costs
11/2/2020,interac purchase - 1660 first truck cen,-11.34,,,,Interac purchase - 1660 FIRST TRUCK CEN,Undefined
11/2/2020,interac purchase - 0736 mobil@ - 1772,-20,,,,Interac purchase - 0736 MOBIL@ - 1772,Fuel costs
11/2/2020,online transfer sent - 2597 khaled alardud,-1250,,,,Online transfer sent - 2597 KHALED ALARDUD,Undefined
11/2/2020,misc payment pay-file fees,-2,,,,Misc Payment PAY-FILE FEES,Undefined
11/2/2020,auto insurance millennium ins,-194.25,,,,Auto Insurance MILLENNIUM INS,Undefined
11/2/2020,insurance cooperators csi,-989.27,,-4254.51,,Insurance Cooperators CSI,Undefined
11/2/2020,monthly fee,-5,,,,Monthly fee,Undefined
11/2/2020,regular transaction fee 3 drs 2.50,-7.5,,-4242.01,,Regular transaction fee 3 Drs  2.50,Undefined
11/4/2020,interac purchase - 5363 petro-canada,-20,,,,Interac purchase - 5363 PETRO-CANADA,Fuel costs
11/4/2020,interac purchase - 6089 omega locksmith,-260,,-3962.01,,Interac purchase - 6089 OMEGA LOCKSMITH,Undefined
11/5/2020,misc payment clarke transpor,,-5805.12,,,Misc Payment CLARKE TRANSPOR,Undefined
11/5/2020,cash withdrawal,-5000,,-4767.13,,Cash withdrawal,Undefined
11/6/2020,e-transfer received,,-500,-5267.13,,e-Transfer received,Undefined
11/6/2020,interac purchase - 5559 the bedouins re,-68.23,,-5198.9,,Interac purchase - 5559 THE BEDOUINS RE,Undefined
11/9/2020,e-transfer received borama trucking ltd.,,-300,-5498.9,,e-Transfer received BORAMA TRUCKING LTD.,Undefined
11/9/2020,atm withdrawal - ed757928,-1000,,,,ATM withdrawal - ED757928,Undefined
11/9/2020,interac purchase - 3851 princess auto 0,-20.99,,,,Interac purchase - 3851 PRINCESS AUTO 0,Undefined
11/9/2020,interac purchase - 8284 esso 7-eleven 3,-72.79,,,,Interac purchase - 8284 ESSO 7-ELEVEN 3,Fuel costs
11/9/2020,online transfer sent - 7799 khaled alardud,-100,,,,Online transfer sent - 7799 KHALED ALARDUD,Undefined
11/9/2020,cheque - 999435,-1822.75,,,,Cheque - 999435,Undefined
11/9/2020,cheque - 999429,-2251.5,,-230.87,,Cheque - 999429,Undefined
11/12/2020,misc payment clarke transpor,,-5603.9,,,Misc Payment CLARKE TRANSPOR,Undefined
11/12/2020,atm withdrawal - ei316767,-200,,,,ATM withdrawal - EI316767,Undefined
11/12/2020,interac purchase - 4225 tim hortons,-6.05,,,,Interac purchase - 4225 TIM HORTONS #24,Meals and entertainment
11/12/2020,interac purchase - 6871 first truck cen,-59.41,,,,Interac purchase - 6871 FIRST TRUCK CEN,Undefined
11/12/2020,online transfer sent - 3947 khaled alardud,-1000,,-4569.31,,Online transfer sent - 3947 KHALED ALARDUD,Undefined
11/13/2020,e-transfer received borama trucking ltd.,,-2411,-6980.31,,e-Transfer received BORAMA TRUCKING LTD.,Undefined
11/13/2020,interac purchase - 2816 shell flying J,-75,,,,Interac purchase - 2816 SHELL FLYING J,Fuel costs
11/13/2020,interac purchase - 1153 shell flying J,-300,,,,Interac purchase - 1153 SHELL FLYING J,Fuel costs
11/13/2020,online banking transfer - 4671,-2053.38,,-4551.93,,Online Banking transfer - 4671,Undefined
11/16/2020,e-transfer sent khaled alamari,-1537.45,,-3014.48,,e-Transfer sent khaled alamari,Undefined
11/16/2020,interac purchase - 8727 turquaz kebab H,-66.89,,-2947.59,,Interac purchase - 8727 TURQUAZ KEBAB H,Undefined
11/17/2020,interac purchase - 0648 shell flying J,-400,,,,Interac purchase - 0648 SHELL FLYING J,Fuel costs
11/17/2020,cheque - 999430,-1978,,-569.59,,Cheque - 999430,Undefined
11/19/2020,misc payment clarke transpor,,-4106.69,,,Misc Payment CLARKE TRANSPOR,Undefined
11/19/2020,interac purchase - 1829 c01 dit170st-o,-89.44,,,,Interac purchase - 1829 C01 DIT(170ST-O,Undefined
11/19/2020,insurance cooperators csi,-487.34,,-4099.5,,Insurance Cooperators CSI,Undefined
11/20/2020,e-transfer sent bashir,-2000,,-2099.5,,e-Transfer sent Bashir,Undefined
11/23/2020,atm withdrawal - ei318148,-100,,,,ATM withdrawal - EI318148,Undefined
11/23/2020,interac purchase - 1844 bianca amors li,-8.4,,,,Interac purchase - 1844 BIANCA AMORS LI,Undefined
11/23/2020,interac purchase - 9092 walmart store,-12.6,,,,Interac purchase - 9092 WALMART STORE #,Supplies
11/23/2020,interac purchase - 9591 city truck stop,-25.99,,,,Interac purchase - 9591 CITY TRUCK STOP,Undefined
11/23/2020,interac purchase - 5304 north central C,-76.01,,,,Interac purchase - 5304 NORTH CENTRAL C,Undefined
11/23/2020,interac purchase - 3597 shell flying J,-265.2,,,,Interac purchase - 3597 SHELL FLYING J,Fuel costs
11/23/2020,interac purchase - 9339 city truck stop,-500.85,,-1110.45,,Interac purchase - 9339 CITY TRUCK STOP,Undefined
11/24/2020,interac purchase - 1125 tim hortons,-3.13,,,,Interac purchase - 1125 TIM HORTONS #63,Meals and entertainment
11/24/2020,interac purchase - 5355 shell flying J,-50,,,,Interac purchase - 5355 SHELL FLYING J,Fuel costs
11/24/2020,interac purchase - 5888 copart,-93.45,,-963.87,,Interac purchase - 5888 COPART #204,Undefined
11/25/2020,interac purchase - 8918 turquaz kebab H,-7.35,,,,Interac purchase - 8918 TURQUAZ KEBAB H,Undefined
11/25/2020,interac purchase - 8892 edmonton fadez,-33.5,,,,Interac purchase - 8892 EDMONTON FADEZ,Undefined
11/25/2020,interac purchase - 5908 turquaz kebab H,-70.04,,,,Interac purchase - 5908 TURQUAZ KEBAB H,Undefined
11/25/2020,interac purchase - 7580 shell flying J,-300,,-552.98,,Interac purchase - 7580 SHELL FLYING J,Fuel costs
11/26/2020,misc payment clarke transpor,,-5663.39,,,Misc Payment CLARKE TRANSPOR,Undefined
11/26/2020,interac purchase - 1139 turquaz kebab H,-14.6,,-6201.77,,Interac purchase - 1139 TURQUAZ KEBAB H,Undefined
9/28/2020,interac purchase - 6060 walmart store,-11.5,,,,Interac purchase - 6060 WALMART STORE #,Supplies
9/28/2020,interac purchase - 2492 pita basket,-42,,,,Interac purchase - 2492 PITA BASKET,Undefined
9/28/2020,interac purchase - 8041 fas gas refiner,-50,,,,Interac purchase - 8041 FAS GAS REFINER,Fuel costs
9/28/2020,interac purchase - 5953 fatima restaura,-52.4,,,,Interac purchase - 5953 FATIMA RESTAURA,Undefined
9/28/2020,interac purchase - 1172 jerusalem shawa,-52.49,,,,Interac purchase - 1172 JERUSALEM SHAWA,Undefined
9/28/2020,online banking transfer - 2307,-1444.36,,-2355.53,,Online Banking transfer - 2307,Undefined
9/29/2020,interac purchase - 7418 xiao ping foot,-63,,-2292.53,,Interac purchase - 7418 XIAO PING FOOT,Undefined
9/30/2020,interac purchase - 7633 fort garry indu,-5.78,,,,Interac purchase - 7633 FORT GARRY INDU,Undefined
9/30/2020,interac purchase - 0467 first truck cen,-7.85,,,,Interac purchase - 0467 FIRST TRUCK CEN,Undefined
9/30/2020,interac purchase - 6174 shell flying J,-14.5,,-2264.4,,Interac purchase - 6174 SHELL FLYING J,Fuel costs
10/1/2020,misc payment clarke transpor,,-3780.08,,,Misc Payment CLARKE TRANSPOR,Undefined
10/1/2020,interac purchase - 0766 tim hortons,-5.64,,,,Interac purchase - 0766 TIM HORTONS #74,Meals and entertainment
10/1/2020,online transfer sent - 0202 khaled alardud,-800,,,,Online transfer sent - 0202 KHALED ALARDUD,Undefined
10/1/2020,misc payment pay-file fees,-2,,,,Misc Payment PAY-FILE FEES,Undefined
10/1/2020,auto insurance millennium ins,-194.25,,,,Auto Insurance MILLENNIUM INS,Undefined
10/1/2020,insurance cooperators csi,-739.93,,-4302.66,,Insurance Cooperators CSI,Undefined
10/1/2020,monthly fee,-5,,-4297.66,,Monthly fee,Undefined
10/2/2020,atm deposit - ei310620,,-3015,-7312.66,,ATM deposit - EI310620,Undefined
10/2/2020,interac purchase - 0495 sunbake pita ba,-11,,-7301.66,,Interac purchase - 0495 SUNBAKE PITA BA,Undefined
10/5/2020,atm deposit - ea566097,,-438.75,,,ATM deposit - EA566097,Undefined
10/5/2020,interac purchase refund - 8419 part source,,-152,,,Interac purchase refund - 8419 PART SOURCE #72,Undefined
10/5/2020,e-transfer sent sarder,-1000,,-6892.41,,e-Transfer sent sarder,Undefined
10/5/2020,interac purchase - 1143 tim hortons,-4.18,,,,Interac purchase - 1143 TIM HORTONS #22,Meals and entertainment
10/5/2020,interac purchase - 4705 city truck stop,-20,,,,Interac purchase - 4705 CITY TRUCK STOP,Undefined
10/5/2020,interac purchase - 7978 city truck stop,-42.89,,,,Interac purchase - 7978 CITY TRUCK STOP,Undefined
10/5/2020,interac purchase - 1908 mobil@ - 1772,-60,,,,Interac purchase - 1908 MOBIL@ - 1772,Fuel costs
10/5/2020,interac purchase - 3027 petro-canada,-60,,,,Interac purchase - 3027 PETRO-CANADA,Fuel costs
10/5/2020,interac purchase - 9613 part source,-186.89,,,,Interac purchase - 9613 PART SOURCE #72,Undefined
10/5/2020,interac purchase - 3190 part source,-270.88,,,,Interac purchase - 3190 PART SOURCE #72,Undefined
10/5/2020,cash withdrawal,-2716,,,,Cash withdrawal,Undefined
10/5/2020,online transfer sent - 5884 khaled alardud,-500,,-3031.57,,Online transfer sent - 5884 KHALED ALARDUD,Undefined
10/6/2020,interac purchase - 1113 shell flying J,-2.76,,-3028.81,,Interac purchase - 1113 SHELL FLYING J,Fuel costs
10/8/2020,misc payment clarke transpor,,-4100.67,,,Misc Payment CLARKE TRANSPOR,Undefined
10/8/2020,interac purchase - 0010 tim hortons,-6.81,,-7122.67,,Interac purchase - 0010 TIM HORTONS #83,Meals and entertainment
10/9/2020,interac purchase - 7071 turquaz kebab H,-72.82,,,,Interac purchase - 7071 TURQUAZ KEBAB H,Undefined
10/9/2020,online banking transfer - 5455,-1088.09,,-5961.76,,Online Banking transfer - 5455,Undefined
10/13/2020,atm withdrawal - ei312043,-300,,,,ATM withdrawal - EI312043,Undefined
10/13/2020,interac purchase - 0001 tim hortons,-3.68,,,,Interac purchase - 0001 TIM HORTONS #11,Meals and entertainment
10/13/2020,interac purchase - 6039 walmart store,-32.5,,,,Interac purchase - 6039 WALMART STORE #,Supplies
10/13/2020,interac purchase - 0194 kabsa the ultim,-51.41,,-5574.17,,Interac purchase - 0194 KABSA THE ULTIM,Undefined
10/14/2020,interac purchase - 5908 tim hortons,-5.74,,-5568.43,,Interac purchase - 5908 TIM HORTONS #83,Meals and entertainment
10/15/2020,misc payment clarke transpor,,-3526.34,,,Misc Payment CLARKE TRANSPOR,Undefined
10/15/2020,interac purchase - 9359 shell flying J,-3.98,,,,Interac purchase - 9359 SHELL FLYING J,Fuel costs
10/15/2020,online transfer sent - 9636 khaled alardud,-2000,,-7090.79,,Online transfer sent - 9636 KHALED ALARDUD,Undefined
10/16/2020,interac purchase - 9403 shell flying J,-3.14,,,,Interac purchase - 9403 SHELL FLYING J,Fuel costs
10/16/2020,interac purchase - 1867 shell flying J,-200,,-6887.65,,Interac purchase - 1867 SHELL FLYING J,Fuel costs
10/19/2020,atm deposit - ei313061,,-900,,,ATM deposit - EI313061,Undefined
10/19/2020,atm deposit - ei313062,,-2390,-10177.65,,ATM deposit - EI313062,Undefined
10/19/2020,atm withdrawal - ei313100,-300,,,,ATM withdrawal - EI313100,Undefined
10/19/2020,interac purchase - 3820 shell c11994,-17.54,,,,Interac purchase - 3820 SHELL C11994,Fuel costs
10/19/2020,interac purchase - 8521 petro-canada,-50.18,,,,Interac purchase - 8521 PETRO-CANADA,Fuel costs
10/19/2020,interac purchase - 1043 shell c03403,-78.84,,,,Interac purchase - 1043 SHELL C03403,Fuel costs
10/19/2020,interac purchase - 5166 shell flying J,-200,,,,Interac purchase - 5166 SHELL FLYING J,Fuel costs
10/19/2020,interac purchase - 4854 city truck stop,-568.94,,,,Interac purchase - 4854 CITY TRUCK STOP,Undefined
10/19/2020,br to br - 1599,-5708.5,,,,BR TO BR - 1599,Undefined
10/19/2020,insurance cooperators csi,-342.5,,-2911.15,,Insurance Cooperators CSI,Undefined
10/20/2020,interac purchase - 1056 a. alberta regi,-125,,-2786.15,,Interac purchase - 1056 A. ALBERTA REGI,Undefined
10/21/2020,e-transfer sent abdo souden,-500,,-2286.15,,e-Transfer sent abdo souden,Undefined
10/21/2020,atm withdrawal - ei313560,-1000,,,,ATM withdrawal - EI313560,Undefined
10/21/2020,interac purchase - 2445 turquaz kebab H,-23.05,,,,Interac purchase - 2445 TURQUAZ KEBAB H,Undefined
10/21/2020,interac purchase - 0944 shell flying J,-150,,,,Interac purchase - 0944 SHELL FLYING J,Fuel costs
10/21/2020,interac purchase - 1990 shell flying J,-200,,-913.1,,Interac purchase - 1990 SHELL FLYING J,Fuel costs
10/22/2020,misc payment clarke transpor,,-4238.75,,,Misc Payment CLARKE TRANSPOR,Undefined
10/22/2020,online banking transfer - 7146,-567.21,,-4584.64,,Online Banking transfer - 7146,Undefined
10/23/2020,e-transfer sent sarder,-465,,-4119.64,,e-Transfer sent sarder,Undefined
10/23/2020,interac purchase - 2706 north central C,-40,,,,Interac purchase - 2706 NORTH CENTRAL C,Undefined
10/23/2020,interac purchase - 7938 turquaz kebab H,-82.64,,-3997,,Interac purchase - 7938 TURQUAZ KEBAB H,Undefined
10/26/2020,atm withdrawal - ed755945,-200,,,,ATM withdrawal - ED755945,Undefined
10/26/2020,interac purchase - 4786 napa edmonton,-20.99,,,,Interac purchase - 4786 NAPA EDMONTON #,Undefined
10/26/2020,interac purchase - 5565 cedar sweets lt,-25,,,,Interac purchase - 5565 CEDAR SWEETS LT,Undefined
10/26/2020,interac purchase - 0462 shell flying J,-75,,-3676.01,,Interac purchase - 0462 SHELL FLYING J,Fuel costs
10/27/2020,cheque - 999436,-1937,,-1739.01,,Cheque - 999436,Undefined
